10 10
1 1 1 1 1 1 1 1 1 1
1 999 1 1 1 1 1 1 1 1
1 999 1 1 1 1 1 999 1 1
1 1 1 1 1 1 1 999 1 1
1 1 1 1 1 1 1 1 1 1
1 1 1 1 1 1 1 1 1 1
1 1 1 1 1 1 1 1 1 1
1 1 1 1 1 1 1 1 1 1
1 1 1 1 1 1 1 1 1 1
1 1 1 1 1 1 1 1 1 1
